-   #           +
#    #    #     +
#   #A   # # ## +
#   #####   # B#+
# #       #   # +
#          # #  +
#           #   +
#    #          +
#      #      # +