-   #           +
#    #          +
#    A   #      +
#   #   #     B +
# #       #     +
#               +
#               +
#    #          +
#      #      # +