# # #       #
#      #    #
#           +
-           #
#    A      #
#           #