# # #       #
#      #    #
#     # #   +
-    #   #  #
#   #A    # #
#  #        #